..#.....#...
...#...#....
..#######...
.##.###.##..
###########.
#.........#.
#.........#.
..##...##...