............
..##....##..
.####..####.
.##########.
..########..
...######...
....####....
.....##.....
............